NO ./path_to_the_north_texture
SO ./path_to_the_south_texture
WE ./path_to_the_west_texture
EA ./path_to_the_east_texture

F 189,178,70
C 27,154,170

11111111111111111111111111111
1000000000010S010000000000001
10000000000000000000000000001
10000000000000000000000000001
11111111111110011111111111111
            1001
11111111111110011111111111111
10000000000000000000000000001
11111111111111111111111111111