NO ./assets/zelij.xpm
SO ./assets/purple_tiles.xpm
WE ./assets/dirt_wall.xpm
EA ./assets/blue_wall.xpm


F 233,175,163
C 27,154,170

11111111111111111111111111111
10000000000100010000000000001
1000000000000N000000001111111
10000000000000000000001
100001110101000000000011111
11111111111110011111111111111
            1001
11111111111110011111111111111
10000000000000000000000000001
11111111111111111111111111111


