NO ./assets/spongebob-64x64.xpm
SO ./assets/south.xpm
WE ./assets/west.xpm
EA ./assets/east.xpm

F 189,178,70
C 27,154,170

11111111111111111111111111111
1000000000010S010000000000001
10000000000000000000001111111
10000000000000000000001
10000000000000000000001111111
10000000000000000000000000001
11111111111110011111111111111
            1001
11111111111110011111111111111
10000000000000000000000000001
11111111111111111111111111111