NO ./assets/zelij.xpm
SO ./assets/purple_tiles.xpm
WE ./assets/dirt_wall.xpm
EA ./assets/blue_wall.xpm


F 233,175,163
C 27,154,170

11111111111111111111111111111
11111110111111111111111111111
1111110N011111111111111111111
11111110111111111111111111111
11111111111111111111111111111

11111111111111111111111111111
11111110111111111111111111111
11111111111111111111111111111
