NO ./assets/zelij.xpm
SO ./assets/purple_tiles.xpm
WE ./assets/dirt_wall.xpm
EA ./assets/blue_wall.xpm

F 189,178,70
C 27,154,170

111111111111111111111111111111111
111111111011000001110000000000001
111111111011000001110111111111111
        111101111111110111000111111
11111111111111011101010010001
111111111111111111111111111111

111111111111111111111111111111
    1100000011010101110000001111
111110000000000001100000010001
10000000000000001101010010001
11000001110101011111011110W001111
11110111 1110101 101111010001
11111111 1111111 111111111111