NO ./assets/zelij.xpm
SO ./assets/purple_tiles.xpm
WE ./assets/dirt_wall.xpm
EA ./assets/blue_wall.xpm

F 189,12,70
C 27,154,170

11111111111111111111111111111111
11111111101100000111000W00000001
111111111011000001110111111111111
        111101111111110111000111111
11111111111111011101010010001
11111111111111111111111111111

111111111111111111111111111111
    110000001101010111000000001
111110000000100001100000001001
10000000000000001101010010001
110000011101010111110111100001111
11110111 1110101 101111010001
11111111 1111111 111111111111