NO ./path_to_the_north_texture
SO ./path_to_the_south_texture
WE ./path_to_the_west_texture
EA ./path_to_the_east_texture

F 220,100,0
C 225,30,0

111111111111111111111111111111111
111111111011000001110000000000001
111111111011000001110111111111111
        111101111111110111000111111
11111111111111011101010010001
    1100000011010101110000001111
111110000000000001100000010001
10000000000000001101010010001
11000001110101011111011110N001111
11110111 1110101 101111010001
11111111 1111111 111111111111